#####+######
#..#.....###
#..#.......#
#..#.###...#
#......#...#
###..#######
#..........#
########..##
#......#..##
#......##..#
#@#........#
############