#####+######
#..........#
######..##.#
#...#....#.#
#.##.###.###
#..........#
##########.#
#.#...#..#.#
#...#.#..#.#
#..#####...#
#@.......#.#
############