#####+######
#...#..#...#
#.#.#....#.#
#.#.######.#
#.#........#
#.##########
#..........#
#.#######..#
#.......#..#
######..#..#
#@.........#
############