#####+######
#.##.......#
#..........#
#.##########
#..........#
##########.#
#..........#
#.##########
#..........#
##########.#
#@.........#
############